#########################################
#S......................................#
#..####################################.#
#..#..................................#.#
#..#.################################.#.#
#..#.#..............................#.#.#
#..#.#.############################.#.#.#
#..#.#.#..........................#.#.#.#
#..#.#.#.########################.#.#.#.#
#..#.#.#.#......................#.#.#.#.#
#..#.#.#.#.####################.#.#.#.#.#
#..#.#.#.#.#..................#.#.#.#.#.#
#..#.#.#.#.#.################.#.#.#.#.#.#
#..#.#.#.#.#.#..............#.#.#.#.#.#.#
#..#.#.#.#.#.#.############.#.#.#.#.#.#.#
#..#.#.#.#.#.#.#..........#.#.#.#.#.#.#.#
#..#.#.#.#.#.#.#.########.#.#.#.#.#.#.#.#
#..#.#.#.#.#.#.#.#......#.#.#.#.#.#.#.#.#
#..#.#.#.#.#.#.#.#.####.#.#.#.#.#.#.#.#.#
#..#.#.#.#.#.#.#.#.#..#.#.#.#.#.#.#.#.#.#
#..#.#.#.#.#.#.#.#.#.##.#.#.#.#.#.#.#.#.#
#..#.#.#.#.#.#.#.#.#....#.#.#.#.#.#.#.#.#
#..#.#.#.#.#.#.#.#.######.#.#.#.#.#.#.#.#
#..#.#.#.#.#.#.#.#........#.#.#.#.#.#.#.#
#..#.#.#.#.#.#.#.##########.#.#.#.#.#.#.#
#..#.#.#.#.#.#.#............#.#.#.#.#.#.#
#..#.#.#.#.#.#.##############.#.#.#.#.#.#
#..#.#.#.#.#.#................#.#.#.#.#.#
#..#.#.#.#.#.##################.#.#.#.#.#
#..#.#.#.#.#....................#.#.#.#.#
#..#.#.#.#.######################.#.#.#.#
#..#.#.#.#........................#.#.#.#
#..#.#.#.##########################.#.#.#
#..#.#.#............................#.#.#
#..#.#.##############################.#.#
#..#.#................................#.#
#..#.##################################.#
#..#....................................#
#..######################################
#.......................................#
#......................................E#
#########################################