############
#S####....E#
#....#.#####
####...#####
############