################################################
#S.............................................#
#..............................................#
#..............................................#
#........#######................#######........#
#.......#########..............#########.......#
#.......#########..............#########.......#
#.......#########..............#########.......#
#........#######................#######........#
#..............................................#
#..............................................#
#..............................................#
#..............................................#
#..............................................#
#......................####....................#
#.....................######...................#
#.....................######...................#
#......................####....................#
#..............................................#
#..............................................#
#..............................................#
#..............................................#
#.......##............................##.......#
#........###........................###........#
#.........####....................####.........#
#..........#####................#####..........#
#...........#######..........#######...........#
#.............####################.............#
#................##############................#
#..............................................#
#..............................................#
#..............................................#
#..............................................#
#..............................................#
#..............................................#
#..............................................#
#..............................................#
#..............................................#
#..............................................#
#..............................................#
#..............................................#
#..............................................#
#..............................................#
#..............................................#
#..............................................#
#..............................................#
#..............................................#
#..............................................#
#.............................................E#
################################################